__________
|     B  |
|B      _|
| B    |L|
|        |
|     B  |
|  BB    |
|      B |
|S   B   |
__________